|----|----|----|----|----|----|----|----|----|----|----|----|----|----|----|
|    |    |    |    |    |    |    |    | e  |    |    |    |    |    |    |
|    |    |  p |    |    l    |    |    | e  |    l    |    |    |    |    |
|    |    |    |    |    |    |    |    | e  |    |    |    |    |    |    |
|----|----|----|----|----|    |    |    |    |    |----|----|----|----|----|
|    |    |    |    |    |    |    |    |    |    |    |    |    |    |    |
|    |    |    |    |    l    |    |    |    |    l    |    |    |    |    |
|    |    |    |    |    |    |    |    |    |    |    |    |    |    |    |
|----|----|----|----|----|----|----|----|----|----|----|----|----|----|----|