3 8 8 8 5 3 8 8 8 5 3 8 8 8 5 3 8 8 8 5 3 8 8 8 5
1 2 2 2 2 2 2 2 2 0 1 2 2 2 0 1 2 2 2 0 1 2 2 2 0
1 2 2 2 2 2 2 2 2 0 1 2 2 2 4 a 2 2 2 4 a 2 2 2 0
1 2 2 2 2 2 2 2 2 0 1 2 2 2 0 1 2 2 2 0 1 2 2 2 0
7 2 2 2 6 7 9 9 9 6 7 9 c 9 6 7 9 9 9 6 7 9 9 9 6
3 2 2 2 5 3 8 8 8 5 3 8 b 8 5 3 8 8 8 5 3 8 8 8 5
1 2 2 2 2 2 2 2 2 2 2 2 2 2 2 2 2 2 2 0 1 2 2 2 0
1 2 2 2 2 2 2 2 2 2 2 2 2 2 2 2 2 2 2 4 a 2 2 2 0
1 2 2 2 2 2 2 2 2 2 2 2 2 2 2 2 2 2 2 0 1 2 2 2 0
7 9 9 9 6 7 2 2 2 6 7 9 c 9 6 7 9 9 9 6 7 9 9 9 6
3 8 8 8 5 3 2 2 2 5 3 8 b 8 5 3 8 8 8 5 3 8 8 8 5
1 2 2 2 0 1 2 2 2 0 1 2 2 2 0 1 2 2 2 0 1 2 2 2 0
1 2 2 2 4 a 2 2 2 0 1 2 2 2 4 a 2 2 2 4 a 2 2 2 0
1 2 2 2 0 1 2 2 2 0 1 2 2 2 0 1 2 2 2 0 1 2 2 2 0
7 9 9 9 6 7 9 c 9 6 7 9 c 9 6 7 9 9 9 6 7 9 9 9 6
3 8 8 8 5 3 8 b 8 5 3 8 b 8 5 3 8 8 8 5 3 8 8 8 5
1 2 2 2 0 1 2 2 2 0 1 2 2 2 0 1 2 2 2 0 1 2 2 2 0
1 2 2 2 4 a 2 2 2 0 1 2 2 2 4 a 2 2 2 4 a 2 2 2 0
1 2 2 2 0 1 2 2 2 0 1 2 2 2 0 1 2 2 2 0 1 2 2 2 0
7 2 2 2 6 7 2 2 2 6 7 9 c 9 6 7 9 9 9 6 7 9 9 9 6
3 2 2 2 5 3 2 2 2 5 3 8 b 8 5 3 8 8 8 5 3 8 8 8 5
1 2 2 2 2 2 2 2 2 0 1 2 2 2 0 1 2 2 2 0 1 2 2 2 0
1 2 2 2 2 2 2 2 2 0 1 2 2 2 2 2 2 2 2 4 a 2 2 2 0
1 2 2 2 2 2 2 2 2 0 1 2 2 2 0 1 2 2 2 0 1 2 2 2 0
7 9 9 9 6 7 9 9 9 6 7 9 9 9 6 7 9 9 9 6 7 9 9 9 6